                              ________________________________________ _
                              ________________________________________ _
                    DDD       ______DDDDDDD_________________________ _ _
       DDDD              EDDD ____E____ _________________________ ____ _
      D        DDDD          D  DDD     ___EDDDD_________________ ____ _
     D                        D         _________AB____DDDD_____W ____ _
 S _D E_    AB   EGH___AB  _EE  EGH______AB__EDDDDD____EEEEAB__UV ___   
FFFFFFFFFFFFFFFFFFFFFFFFFFFFFFFFFFFFFFFFFFFFFFFFFFFFFFFFFFFFFFFFFFF     
