                              ____________________________________ ___
            E                 ___________E________________________ ___
        DDDD       AB E       ____________E_______________ E______ ___
      E          DDDDD  E     _________ GH_E_____E E ____GH ______ ___
   DDDD                DD    EDDE    DDDDD______________DDD ______ ___
                                        _________AB____D________L_ ___
 S _   _GH___E_GH_____________GH_____  _______DDDDD______EEE___KM_ ___
FFFFFFFFFFFFFFFFFFFFFFFFFFFFFFFFFFFFFFFFFFFFFFFFFFFFFFFFFFFFFFFFFFF   
